10,10
Arena
02,02,02,02,02,02,02,02,02,02,
02,01,01,01,01,01,01,01,01,02,
02,01,02,02,01,01,02,02,01,02,
02,01,02,01,01,01,01,02,01,02,
02,01,01,01,02,02,01,01,01,02,
02,01,01,01,02,02,01,01,01,02,
02,01,02,01,01,01,01,02,01,02,
02,01,02,02,01,01,02,02,01,02,
02,01,01,01,01,01,01,01,01,02,
02,02,02,02,02,02,02,02,02,02,
000,001,001,000
001,008,001,001
001,008,008,001