10,20
Default
02,02,02,02,02,02,02,02,02,02,
02,01,01,01,02,01,01,01,01,02,
02,02,02,01,02,01,01,01,01,02,
02,01,01,01,02,01,01,01,01,02,
02,01,01,01,02,01,01,01,01,02,
02,01,01,01,02,01,01,01,01,02,
02,01,01,01,02,01,01,01,01,02,
02,01,01,02,02,01,01,01,01,02,
02,01,01,01,01,01,01,01,01,02,
02,02,02,02,02,02,02,02,01,02,
02,01,01,01,01,01,01,01,01,02,
02,01,01,01,02,02,02,02,02,02,
02,02,02,01,02,01,01,01,01,02,
02,01,01,01,02,01,01,01,01,02,
02,01,01,01,02,01,01,01,01,02,
02,01,01,01,02,01,01,01,01,02,
02,01,01,01,02,01,01,01,01,02,
02,01,01,02,02,01,01,01,01,02,
02,01,01,01,01,01,01,01,01,02,
02,02,02,02,02,02,02,02,02,02,
000,001,001,000
001,008,001,001
002,008,012,001